Midnight surge! Restore the power and help everyone before you can leave.

Midnight at the Animal Shelter
An Interactive Fiction by Mirta Vukovic
Release 1 / Serial number 260112 / Inform 7 v10.1.2 / D

Reception
The main lobby. Dragec the guard is slumped in his chair. Exit is north, Animal Ward east, and Staff Office south.

You can see an exit door, a flashlight, a squeaky toy and Dragec here.

>go east
It is too dark to enter the dog room without a light.

>inventory
You are carrying nothing.

>take flashlight
Taken.

>go east
Dog Room
A room with several dog beds. Bruno the dog looks nervous.

You can see Bruno here.

>pet Bruno
Bruno is too nervous. Maybe something could help him relax.

* * *

Midnight surge! Restore the power and help everyone before you can leave.

Midnight at the Animal Shelter
An Interactive Fiction by Mirta Vukovic
Release 1 / Serial number 260112 / Inform 7 v10.1.2 / D

Reception
The main lobby. Dragec the guard is slumped in his chair. Exit is north, Animal Ward east, and Staff Office south.

You can see an exit door, a flashlight, a squeaky toy and Dragec here.

>inventory
You are carrying nothing.

* * *

>take flashlight
Taken.

>take squeaky toy
Taken.

>s
Staff Office
A cluttered office. A ladder leads up to the attic.

You can see Rea, Kiwi, a dog blanket, a cat food, a fuse and a coffee mug here.

>take dog blanket
Taken.

>take cat food
Taken.

>take fuse
Taken.

>take coffee mug
Taken.

>s
You can't go that way.

>n
Reception
The main lobby. Dragec is here. Exit is north, Animal Ward east, and Staff Office south.

You can see an exit door and Dragec here.

>wake Dragec
That seems unnecessary.

* * *

Midnight surge! Restore the power and help everyone before you can leave.

Midnight at the Animal Shelter
An Interactive Fiction by Mirta Vukovic
Release 1 / Serial number 260112 / Inform 7 v10.1.2 / D

Reception
The main lobby. Dragec the guard is slumped in his chair. Exit is north, Animal Ward east, and Staff Office south.

You can see an exit door, a flashlight, a squeaky toy and Dragec here.

>look
Reception
The main lobby. Dragec the guard is slumped in his chair, snoring loudly. Exit is north, Animal Ward east, and Staff Office south.

You can see an exit door, Dragec, a flashlight and a squeaky toy here.

>inventory
You are carrying nothing.

* * *

>go east
Dog Room
A room with several dog beds. Bruno the dog looks nervous.

You can see Bruno here.

>pet bruno
Bruno is too nervous. Maybe something could help him relax.

>pet Bruno
Bruno is too nervous. Maybe something could help him relax.

>go north
You can't go that way.

>go west
Reception
The entrance of the animal shelter. The exit door is to the north.

You can see an exit door here.

* * *

>look
Reception
The main lobby. Dragec the guard is slumped in his chair, snoring loudly. Exit is north, Animal Ward east, and Staff Office south.

You can see an exit door, Dragec, a flashlight and a squeaky toy here.

>take flashlight
Taken.

* * *

>take squeaky toy
Taken.

>wake Dragec
That seems unnecessary.

* * *

Midnight surge! Restore the power and help everyone before you can leave.

Midnight at the Animal Shelter
An Interactive Fiction by Mirta Vukovic
Release 1 / Serial number 260112 / Inform 7 v10.1.2 / D

Reception
The main lobby. Dragec the guard is slumped in his chair. Exit is north, Animal Ward east, and Staff Office south.

You can see an exit door, a flashlight, a squeaky toy and Dragec here.

>n
(first opening the exit door)
The shelter is still without power.

>s
Staff Office
A cluttered office. A ladder leads up to the attic. Kiwi the parrot is perched on a shelf.

You can see a dog blanket, a cat food, a coffee mug, a dog treat, a fuse, Rea and Kiwi here.

>n
Reception
The main lobby. Dragec the guard is slumped in his chair. Exit is north, Animal Ward east, and Staff Office south.

You can see an exit door, a flashlight, a squeaky toy and Dragec here.

>e
Animal Ward
A large room with enclosures. To the south is a wooden closet door.

You can see a closet door, Nara, Ref, Rex and Zumi here.

* * *

Midnight surge! Restore the power and help everyone before you can leave.

Midnight at the Animal Shelter
An Interactive Fiction by Mirta Vukovic
Release 1 / Serial number 260112 / Inform 7 v10.1.2 / D

Reception
The main lobby. Dragec the guard is slumped in his chair. Exit is north, Animal Ward east, and Staff Office south.

You can see an exit door, a flashlight, a squeaky toy and Dragec here.

>north
(first opening the exit door)
The shelter is still without power.

>take flashlight
Taken.

>go north
(first opening the exit door)
The shelter is still without power.

>take squeky toy
You can't see any such thing.

>take squeaky toy
Taken.

>go south
Staff Office
A cluttered office. A ladder leads up to the attic. Kiwi the parrot is perched on a shelf.

You can see a dog blanket, a cat food, a coffee mug, a dog treat, a fuse, Rea and Kiwi here.

>take dog blanket
Taken.

* * *

>take cat food
Taken.

>take coffee mug
Taken.

>take dog treat
Taken.

>take fuse
Taken.

>u
Attic
A dusty space containing the main electrical fusebox.

You can see a fusebox (empty) here.

>put fuse in fusebox
The power hums back to life!

>d
Staff Office
A cluttered office. A ladder leads up to the attic. Kiwi the parrot is perched on a shelf.

You can see Rea and Kiwi here.

* * *

>talk to Kiwi
Kiwi tilts her head. She seems to want some affection first.

>scratch Kiwi
You scratch Kiwi under the chin. She whispers: "Nevenka is in the closet! Kick the door!"

>n
Reception
The main lobby. Dragec the guard is slumped in his chair. Exit is north, Animal Ward east, and Staff Office south.

You can see an exit door and Dragec here.

>e
Animal Ward
A large room with enclosures. To the south is a wooden closet door.

You can see a closet door, Nara, Ref, Rex and Zumi here.

>open colset door
You can't see any such thing.

>open closet door
You need a key.

>pet Nara
She's shivering. Maybe she needs a blanket.

>give Nara dog blanket
Nara calms down. A key falls from her collar!

>pet Ref
Ref relaxes and wags his tail.

>pet Rex
He's barking too much to be petted.

>give squeaky toy to Zumi
Zumi stops running and plays with the toy.

>give dog treat to Rex
Rex happily eats the treat and stops barking.

>e
You can't go that way.

>s
(first opening the closet door)
You need a key.

>n
You can't go that way.

>w
Reception
The main lobby. Dragec the guard is slumped in his chair. Exit is north, Animal Ward east, and Staff Office south.

You can see an exit door and Dragec here.

>give Dragec coffee mug
The smell of coffee wakes Dragec up. "Thanks! Take my Master Key."

>n
(first opening the exit door)
Someone still needs help!

* * *

Midnight surge! Restore the power and help everyone before you can leave.

Midnight at the Animal Shelter
An Interactive Fiction by Mirta Vukovic
Release 1 / Serial number 260112 / Inform 7 v10.1.2 / D

Reception
The main lobby. Dragec the guard is slumped in his chair. Exit is north, Animal Ward east, and Staff Office south.

You can see an exit door, a flashlight, a squeaky toy and Dragec here.

>open exit door
The shelter is still without power.

>s
Staff Office
A cluttered office. A ladder leads up to the attic. Kiwi the parrot is perched on a shelf.

You can see a dog blanket, a cat food, a coffee mug, a dog treat, a fuse, Rea and Kiwi here.

>fuse
That's not a verb I recognise.

>take fuse
Taken.

* * *

>put fuse in fusebox
The power hums back to life!

>d
Staff Office
A cluttered office. A ladder leads up to the attic. Kiwi the parrot is perched on a shelf.

You can see a dog blanket, a cat food, a coffee mug, a dog treat, Rea and Kiwi here.

>n
Reception
The main lobby. Dragec the guard is slumped in his chair. Exit is north, Animal Ward east, and Staff Office south.

You can see an exit door, a flashlight, a squeaky toy and Dragec here.

>open exit door
Someone still needs help!

* * *

Midnight surge! Restore the power and help everyone before you can leave.

Midnight at the Animal Shelter
An Interactive Fiction by Mirta Vukovic
Release 1 / Serial number 260112 / Inform 7 v10.1.2 / D

Reception
The main lobby. Dragec the guard is slumped in his chair. Exit is north, Animal Ward east, and Staff Office south.

You can see an exit door, a flashlight, a squeaky toy and Dragec here.

>s
Staff Office
A cluttered office. A ladder leads up to the attic. Kiwi the parrot is perched on a shelf.

You can see a dog blanket, a cat food, a coffee mug, a dog treat, a fuse, Rea and Kiwi here.

>scratch Kiwi
You scratch Kiwi under the chin. She whispers: "Nevenka is in the closet! Kick the door!"

>take coffee mug
Taken.

>n
Reception
The main lobby. Dragec the guard is slumped in his chair. Exit is north, Animal Ward east, and Staff Office south.

You can see an exit door, a flashlight, a squeaky toy and Dragec here.

>wake Dragec up
That seems unnecessary.

* * *

>s
Staff Office
A cluttered office. A ladder leads up to the attic. Kiwi the parrot is perched on a shelf.

You can see a dog blanket, a cat food, a coffee mug, a dog treat, a fuse, Rea and Kiwi here.

>take coffee mug
Taken.

* * *

>n
Reception
The main lobby. Dragec the guard is slumped in his chair. Exit is north, Animal Ward east, and Staff Office south.

You can see an exit door, a flashlight, a squeaky toy and Dragec here.

>give Dragec coffee mug
The smell of coffee wakes Dragec up. "Thanks! Take my Master Key."

* * *

>take coffee mug
Taken.

>scratch Kiwi
You scratch Kiwi under the chin. She whispers: "Nevenka is in the closet! Kick the door!"

>n
Reception
The main lobby. Dragec the guard is slumped in his chair. Exit is north, Animal Ward east, and Staff Office south.

You can see an exit door, a flashlight, a squeaky toy and Dragec here.

* * *

>give Dragec coffee mug
The smell of coffee wakes Dragec up. "Thanks! Take my Master Key."

>e
Animal Ward
A large room with enclosures. To the south is a wooden closet door.

You can see a closet door, Nara, Ref, Rex and Zumi here.

>open closet door
You kick the door while turning the key. Nevenka is free!

* * *

>scratch Kiwi
You scratch Kiwi under the chin. She whispers: "Nevenka is in the closet! Kick the door!"

>w
You can't go that way.

>n
Reception
The main lobby. Dragec the guard is slumped in his chair. Exit is north, Animal Ward east, and Staff Office south.

You can see an exit door, a flashlight, a squeaky toy and Dragec here.

>give coffee mug to Dragec
The smell of coffee wakes Dragec up. "Thanks! Take my Master Key."

* * *

>s
Staff Office
A cluttered office. A ladder leads up to the attic. Kiwi the parrot is perched on a shelf.

You can see a dog blanket, a cat food, a coffee mug, a dog treat, a fuse, Rea and Kiwi here.

>take fuse
Taken.

>n
Reception
The main lobby. Dragec the guard is slumped in his chair. Exit is north, Animal Ward east, and Staff Office south.

You can see an exit door, a flashlight, a squeaky toy and Dragec here.

* * *

>put fuse in fusebox
The power hums back to life!

>n
You can't go that way.

>s
You can't go that way.

>e
You can't go that way.

>n
You can't go that way.

>w
You can't go that way.

>e
You can't go that way.

* * *

>s
You can't go that way.

>d
Staff Office
A cluttered office. A ladder leads up to the attic. Kiwi the parrot is perched on a shelf.

You can see a dog blanket, a cat food, a coffee mug, a dog treat, Rea and Kiwi here.

* * *

>e
You can't go that way.

>w
You can't go that way.

>d
Staff Office
A cluttered office. A ladder leads up to the attic. Kiwi the parrot is perched on a shelf.

You can see a dog blanket, a cat food, a coffee mug, a dog treat, Rea and Kiwi here.

>w
You can't go that way.

* * *

Midnight surge! Restore the power and help everyone before you can leave.

Midnight at the Animal Shelter
An Interactive Fiction by Mirta Vukovic
Release 1 / Serial number 260112 / Inform 7 v10.1.2 / D

Reception
The main lobby. Dragec the guard is slumped in his chair. Exit is north, Animal Ward east, and Staff Office south.

You can see an exit door, a flashlight, a squeaky toy and Dragec here.

>take flashlight
Taken.

>go east
Dog Room
A room with several dog beds. Nara, a small white-and-brown Shih Tzu, is pacing nervously. Ref, a large German Shorthaired Pointer, is lying quietly in the corner.

You can see Nara and Ref here.

Ref glances at you expectantly. Perhaps he wants some attention or exercise.

>go south
Storage Room
Shelves full of supplies for the animals, including blankets, food, and cleaning tools. Some boxes are stacked high.

You can see a dog blanket and a cat food here.

>take dog blanket
Taken.

>go north
Dog Room
A room with several dog beds. Nara, a small white-and-brown Shih Tzu, is pacing nervously. Ref, a large German Shorthaired Pointer, is lying quietly in the corner.

You can see Nara and Ref here.

Ref glances at you expectantly. Perhaps he wants some attention or exercise.

>pet Nara
You gently pet Nara and wrap her in the blanket. She relaxes and a small key drops from under the blanket.

Ref glances at you expectantly. Perhaps he wants some attention or exercise.

>go west
Reception
The entrance of the animal shelter. The exit door is to the north. There is a small table with a clipboard and a flashlight.

You can see an exit door and a clipboard here.

* * *

>take flashlight
Taken.

>take clipborad
You can't see any such thing.

>go east
Dog Room
A room with several dog beds. Nara, a small white-and-brown Shih Tzu, is pacing nervously. Ref, a large German Shorthaired Pointer, is lying quietly in the corner.

You can see Nara and Ref here.

Ref glances at you expectantly. Perhaps he wants some attention or exercise.

>pet Ref
You give Ref a few gentle pets. He lies down quietly, looking content.

>go south
Storage Room
Shelves full of supplies for the animals, including blankets, food, and cleaning tools. Some boxes are stacked high.

You can see a dog blanket and a cat food here.

* * *

>take cat food
Taken.

>inventory
You are carrying:
  a cat food
  a dog blanket
  a flashlight

>go north
Dog Room
A room with several dog beds. Nara, a small white-and-brown Shih Tzu, is pacing nervously. Ref, a large German Shorthaired Pointer, is lying quietly in the corner.

You can see Nara and Ref here.

>pet Nara
You gently pet Nara and wrap her in the blanket. She relaxes and a small key drops from under the blanket.

I beg your pardon?

>pet Nara
Nara wags her tail happily and snuggles against you.

>pet Nara
Nara wags her tail happily and snuggles against you.

>pet Ref
Ref is already calm and watches you attentively.

>go west
Reception
The entrance of the animal shelter. The exit door is to the north. There is a small table with a clipboard and a flashlight.

You can see an exit door and a clipboard here.

>feed Rea
You can't see any such thing.

* * *

>take squeaky toy
Taken.

>s
Staff Office
A cluttered office. A ladder leads up to the attic. Kiwi the parrot is perched on a shelf.

You can see a dog blanket, a cat food, a coffee mug, a dog treat, a fuse, Rea and Kiwi here.

>take dog blanket
Taken.

* * *

>d
Staff Office
A cluttered office. A ladder leads up to the attic. Kiwi the parrot is perched on a shelf.

You can see Rea and Kiwi here.

>scratch Kiwi
You scratch Kiwi under the chin. She whispers: "Nevenka is in the closet! Kick the door!"

>give cat food to Rea
Rea doesn't seem interested.

>feed Rea
Rea eats happily.

>n
Reception
The main lobby. Dragec the guard is slumped in his chair. Exit is north, Animal Ward east, and Staff Office south.

You can see an exit door and Dragec here.

>give Dragec coffee mug
The smell of coffee wakes Dragec up. "Thanks! Take my Master Key."

* * *

>e
Animal Ward
A large room with enclosures. To the south is a wooden closet door.

You can see a closet door, Nara, Ref, Rex and Zumi here.

>pet Rex
He's barking too much to be petted.

>pet Ref
Ref relaxes and wags his tail.

>give dog blanket to Nara
Nara calms down. A key falls from her collar!

>give squeaky toy to Zumi
Zumi stops running and plays with the toy.

* * *

>give dog treat to Rex
Rex happily eats the treat and stops barking.

>open closet door
You kick the door while turning the key. Nevenka is free!

>n
You can't go that way.

>s
Janitor's Closet
A small, dark supply closet where Nevenka was trapped.

You can see a closet door here.

>w
You can't go that way.

* * *

>e
You can't go that way.

>s
You can't go that way.

>n
Animal Ward
A large room with enclosures. To the south is a wooden closet door.

You can see a closet door, Nevenka, Nara, Ref, Rex and Zumi here.

>n
You can't go that way.

>e
You can't go that way.

>w
Reception
The main lobby. Dragec the guard is slumped in his chair. Exit is north, Animal Ward east, and Staff Office south.

You can see an exit door and Dragec here.

>open exit door
*** You saved the shelter! Mission accomplished. ***

Would you like to RESTART, RESTORE a saved game, QUIT or UNDO the last command?

* * *

>s
Staff Office
A cluttered office. A ladder leads up to the attic. Kiwi the parrot is perched on a shelf.

You can see a dog blanket, a cat food, a coffee mug, a dog treat, a fuse, Rea and Kiwi here.

>take dog blanket, cofeee mug
You can't see any such thing.

>take dog blanket
Taken.

>take coffee mug
Taken.

* * *

>give cat food to ea
You can't see any such thing.

>give cat food to Rea
(first taking the cat food)
Rea doesn't seem interested.

>scratch Kiwi
You scratch Kiwi under the chin. She whispers: "Nevenka is in the closet! Kick the door!"

>u
Attic
A dusty space containing the main electrical fusebox.

You can see a fusebox (empty) here.

* * *

>d
Staff Office
A cluttered office. A ladder leads up to the attic. Kiwi the parrot is perched on a shelf.

You can see Rea and Kiwi here.

>s
You can't go that way.

* * *

>e
You can't go that way.

>n
Reception
The main lobby. Dragec the guard is slumped in his chair. Exit is north, Animal Ward east, and Staff Office south.

You can see an exit door and Dragec here.

* * *

>pet Rex
He's barking too much to be petted.

>give Rex dog treat
Rex happily eats the treat and stops barking.

>pet Ref
Ref relaxes and wags his tail.

>give Zumi squeaky toy
Zumi stops running and plays with the toy.

>give dog blanket to Nara
Nara calms down. A key falls from her collar!

>open closet door
You kick the door while turning the key. Nevenka is free!

* * *

>w
Reception
The main lobby. Dragec the guard is slumped in his chair. Exit is north, Animal Ward east, and Staff Office south.

You can see an exit door and Dragec here.

>n
(first opening the exit door)
Someone still needs help!

>s
Staff Office
A cluttered office. A ladder leads up to the attic. Kiwi the parrot is perched on a shelf.

You can see Rea and Kiwi here.

>give cat food to Rea
Rea doesn't seem interested.

* * *

>n
Reception
The main lobby. Dragec the guard is slumped in his chair. Exit is north, Animal Ward east, and Staff Office south.

You can see an exit door and Dragec here.

>open exit door
*** You saved the shelter! Mission accomplished. ***

Would you like to RESTART, RESTORE a saved game, QUIT or UNDO the last command?

* * *

>take squeaky toy
Taken.

>wake Dragec
He needs coffee to wake up.

>open exit door
No power.

>e
Animal Ward
A large room with enclosures. To the south is a wooden closet door.

You can see a closet door, Nara, Ref, Rex and Zumi here.

>pet Ref
You pet Ref and he immediately relaxes and wags his tail.

>s
(first opening the closet door)
The door is jammed. Maybe ask the parrot for advice?

>n
You can't go that way.

* * *

>e
You can't go that way.

>s
(first opening the closet door)
The door is jammed. Maybe ask the parrot for advice?

>w
Reception
The main lobby. Dragec the guard is slumped in his chair. Exit is north, Animal Ward east, and Staff Office south.

You can see an exit door and Dragec here.

>s
Staff Office
A cluttered office. A ladder leads up to the attic. Kiwi the parrot is perched on a shelf.

You can see a dog blanket, a cat food, a fuse, a coffee mug, a dog treat, Rea and Kiwi here.

>take dog blanket
Taken.

* * *

>take dog treat
Taken.

>u
Attic
A dusty space containing the main electrical box (fusebox).

You can see a fusebox (empty) here.

>put fuse in box
Power is back!

>d
Staff Office
A cluttered office. A ladder leads up to the attic. Kiwi the parrot is perched on a shelf.

You can see Rea and Kiwi here.

>feed Rea
Rea eats happily.

>talk to Kiwi
Kiwi just tilts her head and whistles. She seems to want some affection first.

* * *

>scratch Kiwi
You gently scratch Kiwi under her chin. She closes her eyes in bliss and then whispers: "Nevenka is in the closet! The door is jammed, kick it!"

>s
You can't go that way.

* * *

>e
Animal Ward
A large room with enclosures. To the south is a wooden closet door.

You can see a closet door, Nara, Ref, Rex and Zumi here.

>pet Nara
She is shivering, maybe she needs a blanket.

>give Nara dog blanket
You give the blanket to Nara. She calms down and a key drops from her collar!

>pet Zumi
Too fast! Maybe an object would distract her?

>give Zumi squeaky toy
Zumi stops running to play with the toy.

>give Rex treats
You can't see any such thing.

>give Rex dog treat
Rex catches the treat and stops barking.

>open closet door
The door is locked. Dragec has the key.

>e
You can't go that way.

>s
(first opening the closet door)
The door is locked. Dragec has the key.

>n
You can't go that way.

* * *

>w
Reception
The main lobby. Dragec the guard is slumped in his chair. Exit is north, Animal Ward east, and Staff Office south.

You can see an exit door and Dragec here.

>wake Dragec
He needs coffee to wake up.

>s
Staff Office
A cluttered office. A ladder leads up to the attic. Kiwi the parrot is perched on a shelf.

You can see Rea and Kiwi here.

>e
You can't go that way.

* * *

>s
You can't go that way.

>n
Reception
The main lobby. Dragec the guard is slumped in his chair. Exit is north, Animal Ward east, and Staff Office south.

You can see an exit door and Dragec here.

>w
You can't go that way.

>give coffee mug to Dragec
The smell of coffee wakes Dragec up! "Thanks for the coffee! Take my Master Key!"

>n
(first opening the exit door)
Someone still needs help!

* * *

>e
Animal Ward
A large room with enclosures. To the south is a wooden closet door.

You can see a closet door, Nara, Ref, Rex and Zumi here.

>open closet door
You kick the door while turning the key. It works! Nevenka is free!

>n
You can't go that way.

* * *

>w
Reception
The main lobby. Dragec the guard is slumped in his chair. Exit is north, Animal Ward east, and Staff Office south.

You can see an exit door and Dragec here.

>open exit
(the exit key)
It isn't something you can open.

>n
(first opening the exit door)

    *** You saved the shelter! Mission accomplished. ***

Would you like to RESTART, RESTORE a saved game, QUIT or UNDO the last command?

* * *

Midnight surge! Restore the power and help everyone before you can leave.

Midnight at the Animal Shelter
An Interactive Fiction by Mirta Vukovic
Release 1 / Serial number 260112 / Inform 7 v10.1.2 / D

Reception
The main lobby. Dragec the guard is slumped in his chair. Exit is north, Animal Ward east, and Staff Office south.

You can see an exit door, a flashlight, a squeaky toy and Dragec here.

>take mirror
Taken.

>wake Dragec
He needs coffee.

>s
Staff Office
A cluttered office. A ladder leads up to the attic. Kiwi the parrot is perched on a shelf.

You can see Rea, Kiwi, a dog blanket, a cat food, a fuse and a coffee mug here.

>talk to Kiwi
Kiwi sees herself in the mirror and gets excited! "KRRAA-KRAA! Nevenka is in the closet! The door is jammed, kick it! KRAA!"

>n
Reception
The main lobby. Dragec the guard is slumped in his chair. Exit is north, Animal Ward east, and Staff Office south.

You can see an exit door, Dragec, a flashlight and a squeaky toy here.

>open exit door
No power.

* * *

>e
Animal Ward
A large room with enclosures. To the south is a wooden closet door.

You can see a closet door, Nara, Ref, Rex and Zumi here.

>pet Nara
Needs a blanket.

>open closet door
The door is locked. Dragec has the key.

>s
(first opening the closet door)
The door is locked. Dragec has the key.

>s
(first opening the closet door)
The door is locked. Dragec has the key.

I beg your pardon?

>w
Reception
The main lobby. Dragec the guard is slumped in his chair. Exit is north, Animal Ward east, and Staff Office south.

You can see an exit door, Dragec, a flashlight and a squeaky toy here.

>s
Staff Office
A cluttered office. A ladder leads up to the attic. Kiwi the parrot is perched on a shelf.

You can see Rea, Kiwi, a dog blanket, a cat food, a fuse and a coffee mug here.

>take coffee mug
Taken.

>take fuse
Taken.

>take dog blanket
Taken.

* * *

>take cat food
Taken.

>n
Reception
The main lobby. Dragec the guard is slumped in his chair. Exit is north, Animal Ward east, and Staff Office south.

You can see an exit door, Dragec, a flashlight and a squeaky toy here.

>wake Dragec
The smell of coffee wakes Dragec up! "Take my Master Key!"

>s
Staff Office
A cluttered office. A ladder leads up to the attic. Kiwi the parrot is perched on a shelf.

You can see Rea and Kiwi here.

>u
Attic
A dusty space containing the main electrical box (fusebox).

You can see a fusebox (empty) here.

* * *

>d
Staff Office
A cluttered office. A ladder leads up to the attic. Kiwi the parrot is perched on a shelf.

You can see Rea and Kiwi here.

>n
Reception
The main lobby. Dragec the guard is slumped in his chair. Exit is north, Animal Ward east, and Staff Office south.

You can see an exit door, Dragec, a flashlight and a squeaky toy here.

>e
Animal Ward
A large room with enclosures. To the south is a wooden closet door.

You can see a closet door, Nara, Ref, Rex and Zumi here.

>pet Nara
Nara calms down. A key drops!

>take exit key
You already have that.

>unlock closet door with master key
That doesn't seem to fit the lock.

>open closet door
You remember Kiwi's advice and kick the door while turning the key. It works! Nevenka is free!

>w
Reception
The main lobby. Dragec the guard is slumped in his chair. Exit is north, Animal Ward east, and Staff Office south.

You can see an exit door, Dragec, a flashlight and a squeaky toy here.

>open exit door
Someone still needs help.

I beg your pardon?

>s
Staff Office
A cluttered office. A ladder leads up to the attic. Kiwi the parrot is perched on a shelf.

You can see Rea and Kiwi here.

>feed Rea
Rea eats happily.

>n
Reception
The main lobby. Dragec the guard is slumped in his chair. Exit is north, Animal Ward east, and Staff Office south.

You can see an exit door, Dragec, a flashlight and a squeaky toy here.

>e
Animal Ward
A large room with enclosures. To the south is a wooden closet door.

You can see Nevenka, a closet door, Nara, Ref, Rex and Zumi here.

>pet Zumi
Too fast!

>n
You can't go that way.

* * *

>s
Janitor's Closet
A small, dark supply closet where Nevenka was trapped.

You can see a closet door here.

>s
You can't go that way.

>w
You can't go that way.

>open exit door
I only understood you as far as wanting to open the exit key.

I beg your pardon?

>n
Animal Ward
A large room with enclosures. To the south is a wooden closet door.

You can see a closet door, Nevenka, Nara, Ref, Rex and Zumi here.

>w
Reception
The main lobby. Dragec the guard is slumped in his chair. Exit is north, Animal Ward east, and Staff Office south.

You can see an exit door, Dragec, a flashlight and a squeaky toy here.

>pet Zumi
You can't see any such thing.

>take squeaky toy
Taken.

>n
(first opening the exit door)
Someone still needs help.

>w
You can't go that way.

>s
Staff Office
A cluttered office. A ladder leads up to the attic. Kiwi the parrot is perched on a shelf.

You can see Rea and Kiwi here.

>s
You can't go that way.

* * *

>w
You can't go that way.

>n
Reception
The main lobby. Dragec the guard is slumped in his chair. Exit is north, Animal Ward east, and Staff Office south.

You can see an exit door, Dragec and a flashlight here.

>s
Staff Office
A cluttered office. A ladder leads up to the attic. Kiwi the parrot is perched on a shelf.

You can see Rea and Kiwi here.

* * *

>s
You can't go that way.

>s
You can't go that way.

>n
Reception
The main lobby. Dragec the guard is slumped in his chair. Exit is north, Animal Ward east, and Staff Office south.

You can see an exit door, Dragec and a flashlight here.

>e
Animal Ward
A large room with enclosures. To the south is a wooden closet door.

You can see a closet door, Nevenka, Nara, Ref, Rex and Zumi here.

>pet Zumi
Zumi stops running.

>n
You can't go that way.

>w
Reception
The main lobby. Dragec the guard is slumped in his chair. Exit is north, Animal Ward east, and Staff Office south.

You can see an exit door, Dragec and a flashlight here.

>open exit door
*** You saved the shelter! Mission accomplished. ***

Would you like to RESTART, RESTORE a saved game, QUIT or UNDO the last command?

* * *

Midnight surge! Restore the power and help everyone before you can leave.

Midnight at the Animal Shelter
An Interactive Fiction by Mirta Vukovic
Release 1 / Serial number 260112 / Inform 7 v10.1.2 / D

Reception
The main lobby. Dragec the guard is slumped in his chair. Exit is north, Animal Ward east, and Staff Office south.

You can see an exit door, a flashlight, a squeaky toy and Dragec here.

>take squeaky toy
Taken.

>take flashlight
Taken.

>s
Staff Office
A cluttered office. A ladder leads up to the attic.

You can see Rea, Kiwi, a dog blanket, a cat food, a fuse and a coffee mug here.

* * *

>take coffee mug
Taken.

>inventory
You are carrying:
  a coffee mug
  a fuse
  a cat food
  a dog blanket
  a flashlight
  a squeaky toy

>n
Reception
The main lobby. Dragec is here. Exit is north, Animal Ward east, and Staff Office south.

You can see an exit door and Dragec here.

* * *

Midnight surge! Restore the power and help everyone before you can leave.

Midnight at the Animal Shelter
An Interactive Fiction by Mirta Vukovic
Release 1 / Serial number 260112 / Inform 7 v10.1.2 / D

Reception
The main lobby. Dragec the guard is slumped in his chair. Exit is north, Animal Ward east, and Staff Office south.

You can see an exit door, a flashlight, a squeaky toy and Dragec here.

>u
You can't go that way.

>s
Staff Office
A cluttered office. A ladder leads up to the attic. Kiwi the parrot is perched on a shelf.

You can see a dog blanket, a cat food, a coffee mug, a dog treat, a fuse, Rea and Kiwi here.

>u
Attic
A dusty space containing the main electrical fusebox.

You can see a fusebox (empty) here.

* * *

Midnight surge! Restore the power and help everyone before you can leave.

Midnight at the Animal Shelter
An Interactive Fiction by Mirta Vukovic
Release 1 / Serial number 260112 / Inform 7 v10.1.2 / D

Reception
The main lobby. Dragec the guard is slumped in his chair. Exit is north, Animal Ward east, and Staff Office south.

You can see an exit door, a flashlight, a squeaky toy and Dragec here.

>wake Dragec
He needs coffee to wake up.

* * *

>pet Nara
She is shivering, maybe she needs a blanket.

>pet Zumi
Too fast! Maybe an object would distract her?

>pet Rex
He is barking too much to be petted. Maybe he's hungry?

>pet Ref
You pet Ref and he immediately relaxes and wags his tail.

>open closet door
The door is jammed. Maybe ask the parrot for advice?

>s
(first opening the closet door)
The door is jammed. Maybe ask the parrot for advice?

>talk to Kiwi
You can't see any such thing.

>s
(first opening the closet door)
The door is jammed. Maybe ask the parrot for advice?

* * *

>talk to Kiwi
You can't see any such thing.

>w
Reception
The main lobby. Dragec the guard is slumped in his chair. Exit is north, Animal Ward east, and Staff Office south.

You can see an exit door, Dragec, a flashlight, a squeaky toy and a mirror here.

>s
Staff Office
A cluttered office. A ladder leads up to the attic. Kiwi the parrot is perched on a shelf.

You can see Rea, Kiwi, a dog blanket, a cat food, a fuse, a coffee mug and a dog treat here.

>talk to Kiwi
Kiwi just whistles. Maybe she needs something to look at?

>w
You can't go that way.

>s
You can't go that way.

>n
Reception
The main lobby. Dragec the guard is slumped in his chair. Exit is north, Animal Ward east, and Staff Office south.

You can see an exit door, Dragec, a flashlight, a squeaky toy and a mirror here.

>take mirror
Taken.

>take  a flashlight
Taken.

>take a squeaky toy
Taken.

>s
Staff Office
A cluttered office. A ladder leads up to the attic. Kiwi the parrot is perched on a shelf.

You can see Rea, Kiwi, a dog blanket, a cat food, a fuse, a coffee mug and a dog treat here.

>talk to Kiwi
Kiwi sees herself in the mirror! "KRRAA! Nevenka is in the closet! The door is jammed, kick it! KRAA!"

>take dog blanket
Taken.

* * *

>take dog treat
Taken.

>feed Rea
Rea eats happily.

* * *

>n
Reception
The main lobby. Dragec the guard is slumped in his chair. Exit is north, Animal Ward east, and Staff Office south.

You can see an exit door and Dragec here.

>give coffee mug to Dragec
The smell of coffee wakes Dragec up! "Thanks for the coffee! Take my Master Key!"

>s
Staff Office
A cluttered office. A ladder leads up to the attic. Kiwi the parrot is perched on a shelf.

You can see Rea and Kiwi here.

* * *

>d
Staff Office
A cluttered office. A ladder leads up to the attic. Kiwi the parrot is perched on a shelf.

You can see Rea and Kiwi here.

>n
Reception
The main lobby. Dragec the guard is slumped in his chair. Exit is north, Animal Ward east, and Staff Office south.

You can see an exit door and Dragec here.

* * *

>e
Animal Ward
A large room with enclosures. To the south is a wooden closet door.

You can see a closet door, Nara, Ref, Rex and Zumi here.

>give dog blanket to Nara
You give the blanket to Nara. She calms down and a key drops from her collar!

>give squeaky toy to Zumi
Zumi stops running to play with the toy.

>give dog treat to Rex
Rex catches the treat and stops barking.

>open closet door
You kick the door while turning the key. It works! Nevenka is free!

* * *

>e
Animal Ward
A large room with enclosures. To the south is a wooden closet door.

You can see a closet door, Nara, Ref, Rex and Zumi here.

>pet nara
You can only do that to something animate.

>pet Nara
You can only do that to something animate.

* * *

>wake Dragec
He needs coffee to wake up.

>wake Dragec up
I only understood you as far as wanting to wake Dragec.

>pet Nara
You can't see any such thing.

>open exit door
The electronic lock needs power. Check the Attic.

>e
Animal Ward
A large room with enclosures. To the south is a wooden closet door.

You can see a closet door, Nara, Ref, Rex and Zumi here.

>pet Nara
Nara is shivering and needs a blanket before she'll let you near her.

>pet Zumi
She's running in such fast circles that you can't even touch her!

>open closet door
It seems to be locked.

>w
Reception
The main lobby. Dragec the guard is slumped in his chair. Exit is north, Animal Ward east, and Staff Office south.

You can see an exit door, Dragec, a flashlight and a squeaky toy here.

>take flashlight
Taken.

* * *

>s
Staff Office
A cluttered office. A ladder leads up to the attic.

You can see Rea, Kiwi, a dog blanket, a cat food, a fuse and a coffee mug here.

>take coffeemug
You can't see any such thing.

>take coffee mug
Taken.

>take dog blanket
Taken.

* * *

>take cat food
Taken.

>feed Rea
Rea eats the cat food happily.

>n
Reception
The main lobby. Dragec the guard is slumped in his chair. Exit is north, Animal Ward east, and Staff Office south.

You can see an exit door and Dragec here.

>wake Dragec
The smell of coffee wakes Dragec up! "Oh no, I fell asleep! Here, take my Master Key and find Nevenka!"

>s
Staff Office
A cluttered office. A ladder leads up to the attic.

You can see Rea, Kiwi and a fuse here.

>u
Attic
A dusty space containing the main electrical box.

You can see a fuse-box (empty) here.

>put fuse in the box
You can't see any such thing.

>put fuse in fuse-box
You can't see any such thing.

* * *

Midnight surge! Restore the power and help everyone before you can leave.

Midnight at the Animal Shelter
An Interactive Fiction by Mirta Vukovic
Release 1 / Serial number 260112 / Inform 7 v10.1.2 / D

Reception
The main lobby. Dragec the guard is slumped in his chair. Exit is north, Animal Ward east, and Staff Office south.

You can see an exit door, a flashlight, a squeaky toy and Dragec here.

>wake Dragec up
I only understood you as far as wanting to wake Dragec.

>wake Dragec
He needs coffee to wake up.

>take flashlight
Taken.

* * *

>take squeaky toy
Taken.

>open exit door
No power.

* * *

>e
Animal Ward
A large room with enclosures. To the south is a wooden closet door.

You can see a closet door, Nara, Ref, Rex and Zumi here.

>open closet door
The door is jammed. Maybe ask the parrot for advice?

>pet Nara
She is shivering, maybe she needs a blanket.

>pet Ref
You pet Ref and he immediately relaxes and wags his tail.

>pet Rex
He is barking too much to be petted. Maybe he's hungry?

>pet Zumi
Too fast! Maybe an object would distract her?

* * *

>give Zumi squeaky toy
Zumi stops running to play with the toy.

>w
Reception
The main lobby. Dragec the guard is slumped in his chair. Exit is north, Animal Ward east, and Staff Office south.

You can see an exit door and Dragec here.

>s
Staff Office
A cluttered office. A ladder leads up to the attic. Kiwi the parrot is perched on a shelf.

You can see Rea, Kiwi, a dog blanket, a cat food, a fuse, a coffee mug and a dog treat here.

>take dog blanket
Taken.

* * *

>take dog treat
Taken.

>talk to Kiwi
Kiwi just tilts her head and whistles. She seems to want some affection first.

* * *

>scratch Kiwi
You gently scratch Kiwi under her chin. She closes her eyes in bliss and then whispers: Nevenka is in the closet! The door is jammed, kick it!"

>u
Attic
A dusty space containing the main electrical box (fusebox).

You can see a fusebox (empty) here.

* * *

>feed Rea
Rea eats happily.

>e
You can't go that way.

* * *

>n
Reception
The main lobby. Dragec the guard is slumped in his chair. Exit is north, Animal Ward east, and Staff Office south.

You can see an exit door and Dragec here.

>wake Dragec
He needs coffee to wake up.

* * *

>s
Staff Office
A cluttered office. A ladder leads up to the attic. Kiwi the parrot is perched on a shelf.

You can see Rea and Kiwi here.

>n
Reception
The main lobby. Dragec the guard is slumped in his chair. Exit is north, Animal Ward east, and Staff Office south.

You can see an exit door and Dragec here.

* * *

>e
Animal Ward
A large room with enclosures. To the south is a wooden closet door.

You can see a closet door, Nara, Ref, Rex and Zumi here.

>n
You can't go that way.

>s
(first opening the closet door)
The door is locked. Dragec has the key.

>w
Reception
The main lobby. Dragec the guard is slumped in his chair. Exit is north, Animal Ward east, and Staff Office south.

You can see an exit door and Dragec here.

* * *

>n
(first opening the exit door)
Someone still needs help!

>e
Animal Ward
A large room with enclosures. To the south is a wooden closet door.

You can see a closet door, Nara, Ref, Rex and Zumi here.

>open closet door
The door is locked. Dragec has the key.

* * *

>w
Reception
The main lobby. Dragec the guard is slumped in his chair. Exit is north, Animal Ward east, and Staff Office south.

You can see an exit door and Dragec here.

>e
Animal Ward
A large room with enclosures. To the south is a wooden closet door.

You can see a closet door, Nara, Ref, Rex and Zumi here.

* * *

>w
Reception
The main lobby. Dragec the guard is slumped in his chair. Exit is north, Animal Ward east, and Staff Office south.

You can see an exit door and Dragec here.

>s
Staff Office
A cluttered office. A ladder leads up to the attic. Kiwi the parrot is perched on a shelf.

You can see Rea and Kiwi here.